%%%%%%%%%%%%%%%%%%%%
%                  %
% .................%
%        o o  P    %
%%%%%%%%%%%%%%%%%%%%